11111111111111111111111
10010000000000000000001
10000000000000001111001
100000000C000000E000001
10000000000001110000001
100000000P0000000000001
10000000011110000000011
10000000001111000100111
10000000100000000000111
11111111111111111111111