11111111111111111111111
1011100P000010000000001
1000000P000CC0001111001
11111111111110000000001
10000000000111110000001
10000000000000000000001
10000000011110000000011
10000C10001111001101111
10001E10100000110001111
11111111111111111111111