11111111111111111111111
10111000000010000000001
10000000000000001111001
11111111111110000000001
10000000000111110000001
10000000000000000000001
1000000P011110000000011
10000010001111001101111
10001E1010000011000C111
11111111111111111111111