11111111111111111111111
1P011000000010000000001
1000000000C010001111001
1111111111111000E000001
10000000000011110000001
100C0000000000000000001
10000000011110000000011
10000000001111000100111
10000000100000000000111
11111111111111111111111