11111111111111111111111
1C010000000000000000001
10000000000000001111C01
100000000C000000E00C001
1000000000000111000C001
100000000P000000000C001
1000000001111000000C001
100000000C111100000C111
10C0000000000000000C111
11111111111111111111111