111111111111111111111111111
1000000C0000000000000000001
1000100CC00000000P111100001
100001000011111000000000001
111001000000010000000000001
100000000000000111000000011
100C000000000000E100000C0C1
111111111111111111111111111