11111111111111111111111
1C010000000000000000001
100P0000000000001111C01
100000000C000000E00C001
10000E000E000111E00C001
1000000000000000000C001
1000000001111000E00C001
100000000C111100E00C001
10C0000000000000E00C001
11111111111111111111111