11111111111111111111111
1C111000000010000000001
10010000000000001111001
11111111111110000000001
10000000000111110000001
10000000000000000000001
1000000P011110000000011
10000000001111001100111
10000E0010000011000C111
11111111111111111111111